1111111111111
100C0000000C1
1000011110001
1P0001E000001
1111111111111